January	announcement
immigration	hearing
army	militant
amnesty	violation
immigrant	community
army	militiaman
rebel	troop
artillery	fire
Australia	Observer
Australia	Gazette
U.N.	ambassador
Hutu	status
News	Lebanon
Nahr	camp
Indy	winner
Nations	Agency
Relief	Agency
hunger	News
health	care
govt	Observer
HILWEH	militant
NRC	IDMC
Australia	Magnet
UN	Agency
Relief	Agency
Bared	camp
roach-	apartment
Sept.	attack
Nahr	camp
